"offence_criminal_code";"year";"offence_category";"number_criminal_offences_registered";"number_criminal_offences_unsolved";"number_criminal_offences_solved";"number_criminal_offences_completed";"number_criminal_offences_completed_unsolved";"number_criminal_offences_completed_solved";"number_criminal_offences_attempted";"number_criminal_offences_attempted_unsolved";"number_criminal_offences_attempted_solved";"spatialunit_uid"
"Subversive propaganda (art. 275bis)";"2021";"State and National Security";"0";"0";"0";"0";"0";"0";"0";"0";"0";"14_A.ADM1"
"Misconduct in public office (art. 314)";"2017";"Official or Professional Duty";"0";"0";"0";"0";"0";"0";"0";"0";"0";"2_A.ADM1"
"Trafficking in human beings (art. 182)";"2018";"Liberty";"0";"0";"0";"0";"0";"0";"0";"0";"0";"6_A.ADM1"
"Causing danger by means of nuclear energy, radioactivity or ionising radiation (art. 226bis)";"2022";"Public Danger";"0";"0";"0";"0";"0";"0";"0";"0";"0";"6_A.ADM1"
"Electoral fraud (art. 282)";"2019";"Will of the People";"0";"0";"0";"0";"0";"0";"0";"0";"0";"4_A.ADM1"
"Sexual acts with minors against payment (art. 196)";"2015";"Sexual Integrity";"0";"0";"0";"0";"0";"0";"0";"0";"0";"24_A.ADM1"
"Assisting offenders (art. 305)";"2009";"Administration of Justice";"11";"0";"11";"10";"0";"10";"1";"0";"1";"19_A.ADM1"
"Misuse of a cheque card or credit card (art. 148)";"2011";"Property";"0";"0";"0";"0";"0";"0";"0";"0";"0";"6_A.ADM1"
"Causing danger by means of genetically modified or pathogenic organisms (art. 230bis)";"2014";"Public Health";"0";"0";"0";"0";"0";"0";"0";"0";"0";"26_A.ADM1"
"Assisting offenders (art. 305)";"2016";"Administration of Justice";"6";"0";"6";"6";"0";"6";"0";"0";"0";"24_A.ADM1"
"High treason (art. 265)";"2009";"State and National Security";"0";"0";"0";"0";"0";"0";"0";"0";"0";"13_A.ADM1"
"Breach of the media duty to provide information (art. 322)";"2014";"Official or Professional Duty";"0";"0";"0";"0";"0";"0";"0";"0";"0";"18_A.ADM1"
"Pornography (art. 197)";"2018";"Sexual Integrity";"44";"23";"21";"44";"23";"21";"0";"0";"0";"12_A.ADM1"
"Overcharging of taxes (art. 313)";"2022";"Official or Professional Duty";"0";"0";"0";"0";"0";"0";"0";"0";"0";"21_A.ADM1"
"Theft by trickery (art. 139)";"2011";"Property";"347";"301";"46";"333";"290";"43";"14";"11";"3";"12_A.ADM1"
"Moving boundary markers (art. 256)";"2009";"Forgery";"1";"0";"1";"1";"0";"1";"0";"0";"0";"25_A.ADM1"
"Obtaining a service without payment (art. 150)";"2012";"Property";"1";"0";"1";"1";"0";"1";"0";"0";"0";"26_A.ADM1"
"Vehicle theft (art. 139)";"2021";"Property";"40021";"37745";"2276";"39590";"37451";"2139";"431";"294";"137";"0_CH"
"Theft from/ out of a vehicle (art. 139)";"2011";"Property";"225";"197";"28";"222";"197";"25";"3";"0";"3";"20_A.ADM1"
"Overcharging of taxes (art. 313)";"2018";"Official or Professional Duty";"1";"0";"1";"1";"0";"1";"0";"0";"0";"0_CH"
"Unlawful abstraction of energy (art. 142)";"2020";"Property";"0";"0";"0";"0";"0";"0";"0";"0";"0";"26_A.ADM1"
"Transmission of human diseases (art. 231)";"2009";"Public Health";"0";"0";"0";"0";"0";"0";"0";"0";"0";"9_A.ADM1"
"Common assault (art. 123)";"2012";"Life and Limb";"181";"25";"156";"179";"25";"154";"2";"0";"2";"20_A.ADM1"
"Neglect of duty to support the family (art. 217)";"2012";"Family";"34";"0";"34";"34";"0";"34";"0";"0";"0";"11_A.ADM1"
"Shoplifting (art. 139)";"2013";"Property";"1365";"143";"1222";"1348";"138";"1210";"17";"5";"12";"12_A.ADM1"
"Administering substances capable of causing injury to children (art. 136)";"2020";"Life and Limb";"8";"0";"8";"8";"0";"8";"0";"0";"0";"21_A.ADM1"
"Neglect of duties of care, supervision or education (art. 219)";"2012";"Family";"8";"1";"7";"8";"1";"7";"0";"0";"0";"24_A.ADM1"
"Vehicle burglary (art. 139)";"2015";"Property";"2948";"2836";"112";"2666";"2564";"102";"282";"272";"10";"25_A.ADM1"
"Sexual acts with persons in institutional care, prisoners or persons on remand (art. 192)";"2014";"Sexual Integrity";"0";"0";"0";"0";"0";"0";"0";"0";"0";"14_A.ADM1"
"Fraud (art. 146)";"2011";"Property";"93";"65";"28";"89";"61";"28";"4";"4";"0";"10_A.ADM1"
"Neglect of duties of care, supervision or education (art. 219)";"2022";"Family";"0";"0";"0";"0";"0";"0";"0";"0";"0";"16_A.ADM1"
"Unlawful activities on behalf of a foreign state (art. 271)";"2012";"State and National Security";"1";"0";"1";"1";"0";"1";"0";"0";"0";"1_A.ADM1"
"Forgery of certificates (art. 252)";"2010";"Forgery";"56";"3";"53";"56";"3";"53";"0";"0";"0";"24_A.ADM1"
"Offence - total";"2010";NA;"16472";"11497";"4975";"16131";"11226";"4905";"341";"271";"70";"11_A.ADM1"
"Foreign operations and activities directed against the security of Switzerland (art. 266bis)";"2014";"State and National Security";"0";"0";"0";"0";"0";"0";"0";"0";"0";"2_A.ADM1"
"Forgery of official marks (art. 246)";"2020";"Counterfeiting of Money, Official Stamps, Official Marks, Weights and Measures";"0";"0";"0";"0";"0";"0";"0";"0";"0";"8_A.ADM1"
"Criminal damage + theft (art. 144)";"2009";"Property";"7187";"6458";"729";"7187";"6458";"729";"0";"0";"0";"2_A.ADM1"
"Reproduction of postage stamps without intent to commit forgery (art.328)";"2010";"Contraventions of Federal Law";"0";"0";"0";"0";"0";"0";"0";"0";"0";"5_A.ADM1"
"Unlawful abstraction of energy (art. 142)";"2013";"Property";"1";"0";"1";"1";"0";"1";"0";"0";"0";"18_A.ADM1"
"Forgery of a document (art. 251)";"2021";"Forgery";"157";"23";"134";"155";"22";"133";"2";"1";"1";"12_A.ADM1"
